NO ./assets/made_wall_n.xpm
SO ./assets/made_wall_s.xpm
WE ./assets/made_wall_w.xpm
EA ./assets/made_wall_e.xpm
D ./assets/made_door.xpm

F 64,64,64
C 182,182,182

1111111111111111111111111
1000000000110000000000001
1011000001110000000000001
1001000000000000000000001
1111111110110000011100001000000011
100000000011000001110111111111111
11110111111111011100000010001
111101111111110111010100D0001
11000000110101011100000010001
10000000000000001100000010001
10000000000000001101010010001
11000001110101011111011110N0111
11110111 1110101 101111010001
11111111 1111111 111111111111
