NO ./assets/okan.xpm
SO ./assets/yohurteb.xpm
WE ./assets/okan.xpm
EA ./assets/okan.xpm

F 220,100,0
C 225,30,0

111111111
100000001
100010001
1000N0001
100000001
111111111
