1111110
1S00001
100N001
1000001
1101111
100      000001
111111100011111
