1111110
1800001
100N001
1000001
1101111
100      R00001
111111100011111
