1111110
1000001
100N000
0000001
1101111
100      000001
111111100011111
