NO ./assets/made_wall_n.xpm
SO ./assets/made_wall_s.xpm
WE ./assets/made_wall_w.xpm
EA ./assets/made_wall_e.xpm
D ./assets/made_door.xpm

Fa 64,     64,      64
C 182,182,182

1111111
1000001
1000001
100N001
1000001
1111111
1101    000001
111111110011111
